1111111111111
1010000000001
1010000000111
1010000001011
100001010P001
1000000100001
1111111111111
