NO ./img/City.xpm
SO ./img/Chelsea.xpm
WE ./img/Arsenal.xpm
EA ./img/United.xpm

F 40,114,51
C 0,191,255


111111111111111111111111111111111111111111111111111111111111111111111111111111111111111111111111111
100010010010010010010010010010010010010010010010010010010010010010010010010010010010010010010010001
101111101110101110101110101110101110101110101110101110101110101110101110101110101110101110101111101
100000000010000000010000000010000000010000000010000000010000000010000000010000000010000000010000001
101101110101110101111101101110101111101101110101110101110101110101110101110101110101110101111101101
100000000000000000000000000000000000000000000000000000000000000000000000000000000000000000000000001
101111111101110101110101110101110101110101110101111101111101111101111101111101111101110101111101101
100010000000010000010000010000010000010000010000010000010000010000010000010000010000010000010000001
111101111101110101110101110101110101110101111101111101111101111101110101110101110101110101111101111
100000000000010000000010000000010000000010000000010000000010000000010000000010000000010000000000001
111101111101110101111101110101111101111101111101110101111101110101111101111101111101111101111101111
100000000000010000000000000000000000000000000000000000000000000000000000000000000000000000000000001
101110111101110101111101110101111101110101111101111101111101111101111101111101111101111101111101101
100010000000010000010000000000000000000000010000010000010000000010000000000000000010000010000010001
101111101111101111101110101111101111101110101111101111101111101110101111101110101111101111101111101
100010000000010000000010000000000000000010000000000010000000000000000010000000010000000010000000001
101110101111101111101110101111101111101110101111101111101111101110101111101110101111101111101111101
100010000010000000010000010000000000000010000000000010000000000000000010000000010000000010000000001
111101111101110101111101111101111101111101110101111101110101111101110101111101111101111101111101111
100000000010000000000000000000000000000000010000000000000000000000000000000000000010000000000000001
111101111111101111101111101110101111101111111101111101111101111101111101110101111101111101111101111
100000000010000000010000000010000000010000010000010000010000010000010000010000010000000010000000001
101111101110101111101110101110101111101110101111101111101111101111101111101111101110101111101111101
100010000010000000010000010000000000000010000010000010000000010000000010000000010000010000010000001
101101111110101111101111101111101110101110101111101110101110101111101111101110101111101111101111101
100000000010000000000000000000000010000000000000000010000000000000000010000000000000010000000010001
111101110101111101110101110101111101110101110101111101111101111101111101110101110101110101111101111
100000000000000000010000000000000000010000000000000000000000010000000000000000010000000010000000001
101111101111101111101111101110101111101111101111101110101111101111101111101111101111101111101111101
100010000000000000000000010000000010000000010000010000010000010000010000010000000010000000010000001
111101111101111101111101111101111101110101110101111101111101110101110101110101111101111101111101111
100000000010000000010000000000000000010000000000000010000000000000000010000000010000000000000000001
101111101111101111101111101111101110101111101111101111101111101111101111101111101111101111101111101
100010000010000000000000000000000010000000010000000010000000010000000010000000000000010000000010001
101110101110101111101110101111101110101110101111101110101110101110101110101110101111101111101111101
100010000000000000010000000000000010000000000000010000000000010000000000000010000000000000010000001
111101111101111101111101110101110101111101110101111101110101111101110101110101110101111101111101111
100000000000000000000000010000000010000000010000000010000000010000000010000000010000000010000000001
111101111101110101111101111101110101111101110101111101111101110101111101111101110101111101111101111
100000000010000000000000010000000010000000010000000000000000010000000000000010000000010000000000001
101111101111101111101111111101111101111101111101111101111101111101111101111101111101111101111101101
100010000010000000010000000000010000000000000010000000000000000010000000000000010000000010000010001
101110101110101110101110101110101110101110101111101110101110101110101110101110101111101110101111101
100000000010000000010000000010000000000000010000000010000000010000000010000000010000000010000000001
111101111101111101111101110101110101110101110101111101110101110101110101110101110101110101111101111
100000000010000000010000000010000000000000010000000010000000010000000010000000010000000010000000001
101111101110101111101111101111101111101111101111101111101111101111101111101111101111101111101111101
100010000010000000010000000000000010000000000000000010000000000000000010000000010000000010000010001
111101111101111101110101110101110101110101110101111101110101110101110101110101110101110101111101111
100000000010000000000000010000000010000000010000000010000000010000000010000000010000000010000000001
111101111101111101111101111101111101110101110101111101111101111101111101110101111101111101111101111
100000000000000000000000010000000010000000010000000010000000010000000010000000010000000010000000001
101111101111101111101111101111101111101111101111101110101111101111101111101111101111101111101111101
100010000010000000010000000000000010000000000000010000000000000000010000000010000000010000010001111
101110101110101110101110101110101110101110101110101110101110101110101110101110101110101110101111101
100010000010000000010000000010000000010000000010000000010000000010000000010000000010000000010000001
111101111101111101110101110101110101110101110101111101110101110101110101110101110101110101111101111
100000000000000000010000000010000000010000000010000000010000000010000000010000000010000000010000001
101111101111101111101111101111101111101111101111101110101111101111101111101111101111101111101111101
100010000010000000010000000000000010000000000000000010000000000000010000000010000000010000010001111
111101111101111101110101110101110101110101110101111101110101110101110101110101110101110101111101111
100000000010000000000000010000000010000000010000000010000000010000000010000000010000000010000000001
111101111101111101111101111101111101111101111101111101110101111101111101111101111101111101111101111
100000000010000000010000E00010000000010000000010000000010000000010000000010000000010000000010000001
101111101111101111101111101111101111101111101111101111101111101111101111101111101111101111101111101
100010000010000000010000000000000010000000000000000010000000000000010000000010000000010000010001111
101110101110101110101110101110101110101110101110101110101110101110101110101110101110101110101111101
100010000010000000010000000010000000010000000010000000010000000010000000010000000010000000010000001
111101111101111101110101110101110101110101110101110101110101110101110101110101110101110101111101111
100000000000000000010000000010000000010000000010000000010000000010000000010000000010000000010000001
101111101111101111101111101111101111101111101111101111101111101111101111101111101111101111101111101
100010000010000000010000000010000000010000000010000000010000000010000000010000000010000000010000001
111111111111111111111111111111111111111111111111111111111111111111111111111111111111111111111111111
