NO ./img/North.xpm
SO ./img/North.xpm
WE ./img/North.xpm
EA ./img/North.xpm
F 40,114,51
C 0,191,255

1111111111111
100000001 
10000000111
10E000001
100001111111111111111111111111111111111111111111111111111111111111111111111111111111111111111111111111111111111
100000001
100000001
10011111111
111111111
