NO ./img/City.xpm
SO ./img/Chelsea.xpm
WE ./img/Arsenal.xpm
EA ./img/United.xpm
F 40,114,51
C 255,0,255


1111111111
1000000001
1000000001
1000000001
1000000001
10000000S1
1000000001
1111111111