NO ./img/North.xpm
SO ./img/North.xpm
WE ./img/North.xpm
EA ./img/North.xpm
F 40,114,51
C 0,191,255

111111111111111111111111111111111111111111111111111111111111111111111111111
100000000000000000000000000000000000000000000000000000000000000000000001111
100100000001001100000100000111101100001011111010011000010000000000000000001
100010000010010010000100000100001010001000100010010100010000000000000000001
100001000100111111000100000111101001001000100010010010010000000000000000001
1000001010010E0000100100000100001000101000100010010001010000000000000000001
100000010010000000010111110111101000011000100010010000110000000000000000001
100000000000000000000000000000000000000000000000000000000000000000000000001
111111111111111111111111111111111111111111111111111111111111111111111111111
