NO ./img/North.xpm
SO ./img/South.xpm
WE ./img/West.xpm
EA ./img/East.xpm
F 40,114,51
C 0,191,255

11111111111111111111111111111111
1000000111111111
1000000001000001
1000000001111001
1000000000000001
1000000000000001
1000000000000001
10E0000011111111
1000000000000001
1000000000000001
1000000000000001
1000000011111111
1000000000000001
1000000000000001
1000000000000001
1000000000000001
1000000000000001
1000000000000001
1000000000000001
1000000000000001
1000000000000001
1000000000000001
1000000111111111
1000000001000001
1000000001111001
1000000000000001
1000000000000001
1000000000000001
1000000011111111
1000000000000001
1000000000000001
1000000000000001
1000000011111111
1000000000000001
1000000000000001
1000000000000001
1000000000000001
1000000000000001
1000000000000001
1000000000000001
1000000000000001
1000000000000001
1111111111111111