NO ./path_to_the_north_texture
SO ./path_to_the_south_texture
WE ./path_to_the_west_texture
EA ./path_to_the_east_texture
F 40,114,51
C 0,191,255

11111111
10000001
10N01001
10001001
10001001
10000001
10000001
11111111