NO ./img/City.xpm
SO ./img/Chelsea.xpm
WE ./img/Arsenal.xpm
EA ./img/United.xpm

F 40,114,51
C 0,191,255

11111111111111111111111111
10000010000000000001000001
100000000000000W0001000001
10000011110000000001110001
10000010010000000000000001
10000010010000000000000001
10000000000000000000000001
11111111111111111111111111
