NO ./img/City.xpm
SO ./img/Chelsea.xpm
WE ./img/Arsenal.xpm
EA ./img/United.xpm

F 40,114,51
C 0,191,255

111111111111111111111111111111111111111111111111111111111111111111
1000000000000000000000000000000000000000000000000000000000000000001111
10010000000100110000010000011110110000101111101001100001000000000000001
100010000010010010000100000100001010001000100010010100010000000000000001
1000010001001111110001000001111010010010001000100100100100000000000000001
10000010100100000010010000010000100010100010001001000101000000000000000001
100000010010000000010111110111101000011000100010010000110000000000000000E01
10000000000000000000000000000000000000000000000000000000000000000000000001
1111111111111111111111111111111111111111111111111111111111111111111111111