NO ./img/North.xpm
SO ./img/North.xpm
WE ./img/North.xpm
EA ./img/North.xpm
F 40,114,51
C 0,191,255

11111111111111111111111111111111111111111111111111111111111111111111111111111111111111111111111111111111111111
1000000000000000000000000000000000000000000000000000000000000000000000011111111111111111111111111111111111
100100000001001100000100000111101100001011111010011000010000000000000000001111111111111111
100010000010010010000100000100001010001000100010010100010000000000000000001111111111111111
10000100010011111100010000011110100100100010001001001001000000000000000000111111111111111111
10000010100100000010010000010000100010100010001001000101000000000000000000111111111111111111
100000010010000000010111110111101000011000100010010000110000000000000000E00000001
10000000000000000000000000000000000000000000000000000000000000000000000001111111
111111111111111111111111111111111111111111111111111111111111111111111111111111111111111111