NO ./img/City.xpm
SO ./img/Chelsea.xpm
WE ./img/Arsenal.xpm
EA ./img/United.xpm

F 40,114,51
C 0,191,255

1111111111111111111111111111111111111111111111111111111111111111111
1000000000000000000000000000000000000000000000000000000000000000001
1000000010001000000000111111000000000000000000000000000000000000001
1000000010001000000000000001000000000000000000000000000000000000001
1000000010001000E00000000001000000000000000000000000000000000000001
1000000011111000000000111111000000000000000000000000000000000000001
1000000000001000000000100000000000000000000000000000000000000000001
1000000000001000000000100000000000000000000000000000000000000000001
1000000000001000000000111111000000000000000000000000000000000000001
1000000000000000000000000000000000000000000000000000000000000000001
1111111111111111111111111111111111111111111111111111111111111111111